Metatron	The greatest angel in Judeo-Christian legend. He is known as the Voice of God or the Angel of Contracts. Despite his duty to maintain the world's order, he shows no mercy towards humanity.
Beelzebub	Demonic Lord of the Flies whose insect minions carry souls for him to control. He is mentioned in the Bible as a leader of evil spirits and is seen as a powerful demon.
Cu Chulainn	A hero in Celtic folklore. He was called Setanta until he earned the name, "Culann's Hound." There are many tales of his adventures. He received his spear, Gae Bolg, from his mentor, Scathach.
Jack-o'-Lantern	A drunkard who tricked the Devil out of taking him to Hell. When refused entry to Heaven, he was forced to wander the earth with only an ember as a light.
Jack Frost	A winter fairy of European descent. He leaves ice patterns on windows and nips people's noses. Though normally an innocent creature, he will freeze his victims to death if provoked.
Pixie	Friendly fairies of the forest that tend to hide from humans. They like to play tricks on the Laz people. It is said they are the souls of dead, unbaptized children.
Cerberus	The guardian hound who prevents anyone from entering or exiting the underworld in Greek lore. It was born from Typhon and Echidna, and is the older brother of Orthrus.
Lilim	A demon who tempts sleeping men and attacks infants. She is the daughter of the demoness, Lilith. Like her mother, she drains men of their essence.
Eligor	One of the 72 demons of the Goetia. He looks like a knight and has the power to see things to come. He also knows much about war.
Odin	The father of all gods in Norse legend. He willingly sacrificed one eye to gain wisdom. In preparation for Ragnarok, he gathers the souls of fallen warriors to his hall, Valhalla.
Hua Po	A spirit of Chinese folklore who dwells in trees once used for hangings. She is smaller than a human and cannot speak, but her voice is said to be as clear and as beautiful as a bird's song.
Decarabia	One of the 72 demons of the Goetia, this demon appears as a pentacle. Keeper of jewels and herbal lore, Decarabia is said to have the ability to shape- shift at will.
Mara	A Buddhist demon that represents the fear of death. Also known as "The Evil One," he sent his daughters to tempt Buddha during his meditations.
Ose	One of the 72 demons of the Goetia, he is known as the President of Hell. He can shape- shift from leopard to human and reveal the truth behind divine mysteries.
Thor	The Norse thunder god and son of Odin, Thor owns the power enhancing belt, Megingjard, and wields Mjolnir, a hammer that causes lightning to strike and returns to its owner if thrown.
Unicorn	A legendary white horse with a single spiral horn. It can only be tamed by a pure maiden, and its horn supposedly has miraculous healing capabilities.
Uriel	One of the four major archangels. His name means "Flame of God," and he knows all the celestial phenomena. He is the first angel Satan met on earth.
Sarasvati	The Hindu goddess of rivers, and patron of speech, writing, learning, the arts, and sciences. Brahma is her husband.
Valkyrie	"Choosers of the slain" in Norse lore. Armed with shining armor and swords, they look for brave warriors to take to Valhalla, so that they may fight in Ragnarok.
Yaksini	A female demon in Hindu lore. Though originally a Dravidian fertility goddess, the spread of Hinduism changed perception of her to a demonic figure. Usually depicted as a nude, voluptuous, female.
Ganesha	The Hindu elephant- headed god. He was originally created by Parvati in order to prevent anyone from watching her bathe. Shiva batted off his original head and replaced it with an elephant's head.
Anubis	The jackal-headed god of the dead and embalming from Egyptian myth. He weighs the hearts of the dead to determine their final destination.
Mot	The Canaanite god of death. Every year he attempts to kill Baal, the god of fertility, only to see him raised from the dead with the help of Baal's sister, Anat.
Raphael	One of the four major archangels, his name means "healer." He recites the history of the fallen angels and the creation of Adam and Eve.
Scathach	A warrior woman of the Land of Shadows in Celtic lore. She taught the hero, Cu Chulainn, the art of war and gave him the spear, Gae Bolg.
High Pixie	The leader of a swarm of pixies. Any pixie in a leadership role or with remarkable power is called by this name.
Barong	A mystical creature in Balinese lore, it represents good and is Rangda's eternal rival. Even if defeated, it will be reborn. The result is a never-ending struggle...
Girimehkala	A giant elephant monster of Sri Lankan myth, it is typically portrayed as being ridden by the Evil One, Mara. Whoever looks into its evil eye is said to be met with misfortune.
King Frost	The king of snow who rules over an infinite number of Jack Frosts. He has the power to freeze the entire world, but is unaware of it due to his naive personality.
Narcissus	A young man of Greek myth. He rejected the nymph Echo, who faded to a whisper out of despair. Cursed by Nemesis, he fell in love with his own reflection and wasted away.
Isis	Osiris's wife as well as his younger sister. Upon the death of her husband, she revived him with her incredible magic power. Isis is seen at many gravesites as the guardian goddess of the dead.
Lamia	A serpentine woman of Greek myth, she was once the queen of Libya. Zeus's jealous wife, Hera, killed her children, causing her to go mad and transform into a monster.
Legion	The spirit who said, "For we are many," in ancient scriptures. The name comes from the Roman military term for an army unit of 3,000 to 6,000 men.
Rakshasa	A Hindu demon. He is an enemy of the gods and attacks humans to feed off of them. His hideous appearance strikes fear into those who see him. Rakshasa shape-shifts to deceive his enemies.
Mokoi	Evil spirits of Murngin lore believed to be reborn shadows. They kidnap and eat children, and strike down any sorcerer who uses black magic.
Forneus	One of the 72 demons of the Goetia, he appears as a great sea monster. Known as the great Marquis of Hell, he is skilled linguistically, and is a master of rhetoric.
Setanta	A brave young man in Celtic myth. After defeating a fierce guard dog, he volunteered to take its place, earning him the nickname "Hound of Culann."
Titania	The queen of the fairies and Oberon's wife. She is derived from the Roman goddess Diana. She was later immortalized in Shakespeare's play "A Midsummer Night's Dream."
Incubus	A male demon of European lore in medieval times. They visit sleeping women and have sexual intercourse with them. The resulting children become witches or wizards.
Oni	An evil monster from Japanese lore known for its hideous appearance and brute strength. They loot and plunder villages, massacring the townspeople with their iron clubs.
Lilith	Said to have been Adam's first wife, she desired to be his equal and refused to obey him. She was cast out of Eden and became a demon of the night. She is the mother of the demoness, Lilim.
Rangda	A wicked witch of Balinese lore, she represents evil and is Barong's eternal rival. Even if defeated, she will come back to life, and their battle will have no end.
Makami	A divine wolf god in Japanese folklore, also written as "Oguchi-no-Magami." It is often drawn on prayer boards to prevent fires and thefts, but it is also feared as a human-eater.
Parvati	A beautiful Hindu goddess of love and one of Shiva's wives. Always by his side, she played a role in opening his third eye. She can turn into Durga or Kali when angered.
Gabriel	One of the four major archangels. She is also the only female angel at this rank. Her name comes from the Sumerian word for "governor." She is the angel who told Mary of her pregnancy.
Zaou-Gongen	Repeller of evil found at Kinpusen by En-no-Ozunu. Believed to be a fusion of Buddha, Guanyin, and Maitreya, he is a god who originated from Japan rather than the Buddhavacana.
Alice	A mysterious blonde girl. She is quite powerful, despite her looks. Some say she is the ghost of a girl who died a sad death. Others say she is a spirit born from someone's imagination.
Kali	A goddess of death and destruction. She is said to be another face of Parvati. She is violent, wears a string of skulls, and carries bloody weapons, but she also blesses her followers.
Kurama Tengu	A type of tengu said to have lived on Mt. Kurama in Kyoto. The most powerful and well-known of the tengu, they have the power to fend off disease and bring good fortune.
Oberon	The king of the fairies and Titania's husband. He is quite old, but due to a curse, his looks are that of a young boy. He often flirts with human women, ending in a scolding from his wife.
Shiki-Ouji	An exceptionally powerful shikigami. Only the most elite onmyoji are able to summon and bind it to paper. It can ward off disaster or cure illness, but its ordinary temperament is quite vicious.
Yamata-no-Orochi	A giant snake with eight heads that Susano-o defeated to save Kushinada-Hime. The legendary sword Ame-no-Murakumo-no- Tsurugi, also known as the "Sword of Kusanagi," emerged from its belly.
Orobas	One of the 72 demons of the Goetia. Known as the Prince of Hell, he appears as a horse and answers questions of the past, present, and future. He is faithful to his conjurer.
Hanuman	A monkey god of Hindu descent. His father is Vayu, the wind god. Extremely nimble, he performed many heroic deeds in the Ramayana. He is powerful, can fly, and can change his shape into many forms.
Archangel	Eighth of the nine orders of angels. Their duty is to minister to humans and deliver messages. They are warriors of Heaven and lead Heaven's forces during battle with the armies of evil.
Obariyon	A "piggyback monster" of Japan that jumps on the backs of those who pass grassy paths. It is heavy and not easily removed, but will turn into gold coins if you can carry it back home.
Queen Mab	The fairy queen in Celtic myth. Often identified with Titania. She would offer mead mixed with her blood to her many consorts.
Sandalphon	Metatron's twin brother in Judeo- Christian lore, he is the master of heavenly songs. It is said that a human would take 500 years to walk the length of his body.
Abaddon	The "Destroyer" and "Angel of the Bottomless Pit," as described in ancient scriptures. He controls locusts and uses them to cause massive destruction to villages.
Shiisaa	A holy beast said to protect houses from evil and bring good fortune. They look similar to Shinto guardian dogs, but are actually modeled after a lion. There are many stories about it in Ryukyu lore.
Sandman	A fairy in German folklore who carries a bag of magical sand, which puts humans to sleep when thrown into their eyes. If the victim resists, the Sandman will sit on their eyelids.
Belial	One of the 72 demons of the Goetia. He led Sodom and Gomorrah to ruin and persecuted Jesus. He grants high social status to those who summon him.
Leanan Sidhe	A beautiful fairy of Irish lore that yearns for the love of a human man. She drains the life of her lovers in return for granting them artistic inspiration.
Cybele	The Phrygian mother goddess of the earth, she is often depicted with wild animals, and lions in particular. She had her priest, Attis, as a lover, but drove him insane when he was forced to marry another.
Chernobog	A cursed god of death, evil, and the night in Slavic lore. His name means "Black God," and he is the counterpart of the "White God," Belobog. Despite being feared, he was also worshipped.
Flauros	One of the 72 demons of the Goetia. He appears as a leopard and can see the past and future. He can control fire and burn all his adversaries to death.
Ippon-Datara	A one-eyed, one- legged monster said to live deep in the mountains of Kumano, Japan. It's believed to be the degraded blacksmith god, Ame no Me- Hitotsu no Kami.
Orthrus	The two-headed pet dog belonging to the giant, Geryon, in Greek myth. He guarded a herd of red oxen, but was killed by Hercules during one of his twelve labors.
Succubus	A female demon of European lore in medieval times. They visit sleeping men and have sexual intercourse with them. The victims don't wake up but may dream of the encounter.
Mothman	A cryptid sighted during the 60s-80s in West Virginia. It has shining red eyes and is named for the fin-like appendages on its sides. It uses its keen sense for blood to track down the source and feed on it.
RESERVE	Taira no Masakado, hero of the Heian period. He claimed the title "Shinno" (New Emperor) and rebelled against the government. He was killed, but it is said he became a demigod.
Dominion	The fourth of the nine orders of angels. Their duty is to oversee the other angels. Their actions are the manifestation of God's will.
Nekomata	Long-lived cats are said to become these malevolent cat demons. Their powers vary according to how long they have lived, ranging from shape-shifting to controlling the dead.
Black Frost	A Jack Frost that yearned for evil. This powerful demon is born when a cute Jack Frost remembers its nature as a demon.
Arahabaki	A mysterious god of ancient Japan. Most famously worshipped by Nagasunehiko, who was defeated in battle against Emperor Jinmu, Arahabaki came to be treated as a symbol of rebellion and defiance.
Angel	Ninth of the nine orders of angels. They are closest in nature to humans. They watch over individuals and warn those who stray from the path.
Skadi	A Norse giantess called the "snow- shoe goddess" and the embodiment of winter. According to legend, all the gods will return to her at the end of Ragnarok.
Kikuri-Hime	The goddess of life in Shinto myth. She once mediated between Izanagi and Izanami during their confrontation in Yomi, the land of the dead.
Chi You	A Chinese god of war, he is said to have invented many weapons. He and his followers rebelled against the Yellow Emperor, Huang Di, but were ultimately defeated.
Power	The sixth of the nine orders of angels. It is said that they were the first order to be created. Their duty is to protect human souls from demons.
Inugami	A dog spirit said to possess people in Japanese lore. Those possessed are in a state of "inu-tsuki" and lose consciousness. Onmyoji use Inugami as familiars.
Nebiros	The general of Hell. He keeps watch over other demons. One of Hell's greatest necromancers, he can control souls and corpses.
RESERVE	Among the eight Yashaou and one of Bishamonten's attendants. Originally a child- eating demon, he was converted by theBuddha and becamea protector figure.
Slime	A primitive monster with a viscous body. There are various theories as to its origin, but it is still under debate. Said to compulsively collect shiny objects.
Anzu	An evil deity of Mesopotamian folklore with an eagle's body and lion's head. While the god Enlil purified himself, Anzu stole the Tablets of Destiny from him.
Yatagarasu	A divine creature in Japanese lore. They are three-legged birds sent by Amaterasu to help humans. They are said to have helped Emperor Jinmu claim victory.
Yoshitsune	A Japanese general of the Genpei War near the end of the Heian era and start of the Kamakura era. His bold ingenuity and ruthless skill with a blade are still praised in Japan today.
Take-Minakata	A Japanese god of war, hunting, and fertility. He fought Take-Mikazuchi for control of Japan and lost. He escaped to Suwa, but was prohibited to leave since.
Ame-no-Uzume	Japanese goddess of entertainment, she governs many sacred dances. She is most famous for luring out Amaterasu, who had barricaded herself inside a cave.
Kushinada	A Japanese goddess. She governs fields and fertility. All of her sisters were sacrificed to Yamata-no-Orochi, but she was saved by Susano-o and became his wife.
Kumbhanda	A Buddhist demon said to drain human life energy. He has dark skin, stands 3 meters tall, and sometimes changes his shape to a gourd. Known to have once served Rudra, the god of storms.
Ongyo-Ki	One of the four oni controlled by Fujiwara no Chikata. By eliminating its aura and preventing others from sensing its presence, it is able to surprise its enemies.
Kin-Ki	One of the four oni controlled by Fujiwara no Chikata, its body is so hard that no weapons can penetrate it. It and its comrades fell into hell through holes that can still be found in modern Iga.
Sui-Ki	One of the four oni controlled by Fujiwara no Chikata, it can cause floods with the swing of its arms. In the Taiheiki, Ki no Tomoo expelled the oni by reading a Japanese poem.
Fuu-Ki	One of the four oni controlled by Fujiwara no Chikata, it sends hurricanes to blow away its enemies. Some say that Fuu-ki is the original ninja.
Jatayu	The Hindu king of birds. In the Ramayana, he fought bravely against Ravana in an attempt to save Sita, Rama's wife and the 7th avatar of Vishnu, but lost.
Kaiwan	A god in Assyrian legend, his name is interchangeable with Sakkut, another incarnation of the star-god, Saturn.
Kelpie	A horse-like fairy of Celtic folklore that lives by the water. It drowns those who ride on it, but is a valuable mount if you can tame it.
Thoth	Egyptian moon god that takes the form of a baboon, he is the one who measures time. He gave Isis the power to resurrect Osiris after he was killed by the evil god Seth.
Dionysus	The Greek god of wine and theater. He was originally a god of life protecting the mountains of Thrace. He taught humans how to make wine.
Apsaras	Hindu water spirits, they are beautiful young women who dance for the gods. They also guide heroes fallen in battle to paradise.
Andras	One of the 72 demons of the Goetia. The great Marquis of Hell, he appears where there is battle to stoke the hatred within soldiers. He helps defeat the enemies of those who summon him.
RESERVE	BLANK
Koropokguru	Small human-like creatures, that have kind, calm personalities. Once coexisting with the Ainu people of Japan, there was a falling out at some point, and they disappeared.
Koppa Tengu	A type of tengu. Their spiritual power is weaker than other tengu, so they are much smaller. They are said to be the reincarnations of long-lived wolves.
Regent	A bluish-tinged diamond that Napoleon Bonaparte had mounted to the pommel of his sword. It was named after the French Regent Philippe II, Duke of Orleans, who had purchased it in 1717.
Queen's Necklace	The diamond necklace that Jeanne de la Motte swindled from jewelers in 1785 by claiming it was on behalf of the Queen of France, Marie Antoinette.
Stone of Scone	Also known as the Stone of Destiny, it is a stone used in the coronations of Scotland's monarchs. Legends say the stone is linked to angels.
Koh-i-Noor	Once called the world's largest diamond, it was cut when it came to the British royal family. It is said to bring bad luck to any man who wears it, so only the females have ever adorned it.
Orlov	A diamond stolen from a Hindu temple that is said to drive its owner to their death. It was cut into smaller pieces in an attempt to break the curse.
Emperor's Amulet	Also known as Charlemagne's talisman, it is said to make its owner an emperor. In between the two gems is a piece of Jesus' cross and a hair of the Virgin Mary.
Hope Diamond	Unlike its name suggests, the Hope Diamond is a cursed jewel that brings ruin from one owner to the next. A few supposed victims include King Louis XVI and his wife, Marie Antoinette.
Crystal Skull	An ancient Out-Of- Place-Artifact found in Central and South America. It is said that if you collect 13 of them in one spot, the truth of the universe will be revealed.
Orichalcum	A metal mentioned in ancient Greek literature. Some accounts say it was merely brass, but other stories suggest it was, in fact, a legendary material.
RESERVE	BLANK
RESERVE	BLANK
RESERVE	BLANK
RESERVE	BLANK
RESERVE	BLANK
RESERVE	BLANK
Mandrake	A magical plant whose roots look like a human. They are valued for their healing properties in potions, but the screams they let out when pulled from the ground will kill anyone who hears them.
Baal	The chief Semitic god who governs over fertility. He is the god of Canaan and brother and consort to the goddess Anat, who saved him from Mot.
Dakini	Hindu deities of passion and relations. They are Kali's attendants. They eat human flesh and gather at graveyards and crematories each night. Their name means "sky dancer."
Silky	A fairy of England and Scotland. She carries out household chores while everyone sleeps and is a welcome spirit. It is said you can hear her silk skirt rustle as she works.
Bugs	A Welsh creature commonly known as "Bugbear" or the "Boogeyman." Its existence is often used by mothers to scare children into behaving.
Black Ooze	A mass of malevolent intent and emotion that failed to become a true demon. All it does is eat prey and grow.
Bicorn	An evil creature with two curving horns. It represents impurity, unlike the Unicorn. Said to be derived from Re'em in the Bible. Another legend says that it feeds off of disloyal husbands.
Mithras	A sun deity who was worshipped in the Roman Empire from the 1st to the 4th century AD. He was said to be reborn after death, and a festival was held on the winter solstice for him.
Sudama	A spirit of rivers and mountains in Japanese lore, they dwell in ancient trees and ageless rocks. They are not evil, and will often appear as humans or supernatural wonders to warn people.
Kodama	Japanese plant spirits born from trees that have lived for a 100 years. Cutting down one of these trees is said to cause misfortune.
Agathion	A general term for familiars used by Judeo-Christian magicians, they are usually sealed away in bottles, rings, or talismans. They torment the target selected by the conjuror.
Onmoraki	A monstrous, fire spitting, Japanese bird with a man's face. It is actually a corpse that was not given a proper memorial service. They appear before monks who neglect their duties.
Nue	A creature of Japanese lore with a monkey's head, tiger's legs, and snake's tail. The Tale of Heike says it hid behind a dark cloud each night to attack the Emperor.
Pisaca	A type of preta, or "hungry ghost," in Hindu lore that eats human corpses. It enters a human through the mouth and causes harm. Those who see one are said to die within nine months.
Melchizedek	An angel of Gnosticism, governing over peace and righteousness. Though said to be the savior of the angels, he used to be a human, the king of Salem.
Baphomet	A goat-headed demon that is worshipped in Black Sabbaths. His name can be used as a catch-all term for demons in general. He would become an object of worship for witches.
Raja Naga	The king of the Naga, a half-man, half-snake tribe in Hindu lore. The dragon kings Nanda and Takshaka of Buddhist myth fall into this royal category.
Naga	Half-snake, half- human divine beings in Hindu lore, worshipped as bringers of rain. They live in the bottoms of lakes and seas, singing and dancing when they are not fighting.
Garuda	A divine bird-man in Hindu lore, he once fought the gods and received immortality in exchange for becoming Vishnu's carrier.
Moloch	A Canaanite god of fire. A bronze statue of a man with a bull's head stands at an altar. Sacrificial children were thrown into the statue after it was heated.
Norn	Goddesses of fate in Norse lore. They live below the roots of Yggdrasil and weave the threads of fate, which even the gods are bound by.
Belphegor	Demonic governor of the deadly sin of sloth. He also excels at invention and discovery. May derive from Ba'al Pe'or, Syrian god of abundant crops.
Berith	One of the 72 demons of the Goetia. Known as the Duke of Hell, he rides a gigantic horse and burns those without manners.
Choronzon	A demon summoned by a sorcerer named Crowley at the beginning of the 20th century. He obstructs those attempting to reach enlightenment.
RESERVE	BLANK
RESERVE	BLANK
RESERVE	BLANK
RESERVE	BLANK
RESERVE	BLANK
RESERVE	BLANK
Nigi Mitama	One of the four aspects of Shinto thought, it works gently to help maintain a calm mind. It is said to aid in one's relations and sociability, and can lead one in a positive direction.
Kushi Mitama	One of the four aspects of Shinto thought, it uses its power to bring good omens. It is said to aid in one's wisdom, observation, and skill, and can mend fractured paths.
Ara Mitama	One of the four aspects of Shinto thought, it has the power to grant ferocity. It is said to aid in one's bravery, growth, and endeavors, though it can lead in a negative direction.
Saki Mitama	One of the four aspects of Shinto thought, it brings great bounty from the hunt. It is said to aid in love, profit, and growth, and can create new paths.
RESERVE	The Arabian mother goddess also known as Allat. She was thought to reside in the Black Stone at the Kaaba. She and her son, Dusura, were worshipped there by desert nomads.
Shiva	One of the major Hindu gods, he is known as the Destroyer but is also related to regeneration. His wife is Parvati.
Michael	One of the four major archangels, he is at the top of the angelic hierarchy. He carries a long spear that can cut through anything, and his name means "One Who Is Like God."
Asura	The Hindu king of Asuras is named Maha Vairocana, or "One Who Shines On All." In Buddhism, he is known as Dainichi Nyorai.
Mada	A giant Hindu monster. Its mouth is so enormous it can swallow the Earth and the heavens in one bite. Its name means "He who intoxicates."
Mother Harlot	The fiend known as the "Whore of Babylon," riding a beast with seven heads and ten horns, she carries a golden cup of abominations and the filth of her acts.
Clotho	The youngest of the three Moirae Sisters of Greek legend. She spins the threads of life with her spindle.
Lachesis	The middle sister of the three Moirae Sisters of Greek legend. She is the apportioner, measuring the thread which determines each person's lifespan.
Atropos	The eldest of the three Moirae Sisters of Greek mythology. She cuts the threads of life for those whose time has come.
Ardha	A god of dual gender whose appearance is half that of the destroyer, Shiva, and half his wife, Parvati. Ardha is the ideal figure of Shaktism, the perfect god.
RESERVE	BLANK
Vishnu	One of the major Hindu gods, he is the preserver and protector of the universe. Legends claim that he will make ten appearances across time and space to strike down evil and uphold justice. 
Hariti	Also known as Kishimojin, she once ate children, but stopped after Buddha changed her ways. She now eats pomegranates and is a goddess of parenting.
Yurlungur	A snake with a rainbow body from Murngin lore. He is a fertility deity who controls the weather and resides in a holy pond filled with rainbow-colored water.
Hecatoncheires	Giants born from Uranus and Gaia. The name means "those with a hundred arms." During the war of the Titans, Zeus freed them from the Underworld to help him obtain victory.
Satanael	An archangel who is said to be the form of Satan before he fell from Heaven. The second son of God, he rebelled against Him for freedom and bestowed free will and chaos upon humanity.
RESERVE	BLANK
RESERVE	BLANK
RESERVE	BLANK
RESERVE	BLANK
RESERVE	BLANK
RESERVE	BLANK
RESERVE	BLANK
RESERVE	BLANK
RESERVE	BLANK
RESERVE	RESERVE Mythology
Orpheus	A Persona of another story. A poet skilled with the lyre. He tried to retrieve his wife from Hades, but she vanished when he looked back before reaching the surface.
Thanatos	A Persona of another story. The Greek god of death, he is the son of Nyx and the twin brother of Hypnos. He is known to provide mortals with a peaceful death.
Izanagi	A Persona of another story. One of the ancient gods who existed before Japan was formed. He created the Oyashima from chaos, then gave birth to countless children and laid the foundation of soil and nature.
Magatsu-Izanagi	A Persona of another story. He is Izanagi's rival and looks just like him. Magatsu means "calamity." Unlike Izanagi, who founded the land and brought order, he leads all back into chaos.
Kaguya	A Persona of another story. A divine being born from a glowing bamboo shoot. Though many proposed to her, none could complete her strict tasks. She eventually returned to her home, the moon.
Ariadne	A Persona of another story. She is the daughter of Minos, the king of Crete. She helped Theseus defeat the Minotaur and gave him a ball of yarn so he could escape the labyrinth.
Asterius	A Persona of another story. Due to a curse on his mother, Pasiphae, he was born a bull-headed monster. Locked away in the labyrinth as the Minotaur, he wielded a double-sided axe.
Tsukiyomi	A Persona of another story. An important god born from the Japanese god Izanagi, he governs over the moon and the night. There are many theories behind this mysterious god.
Messiah	A Persona of another story. He appears before Judgment Day to save the virtuous. He is a universal figure, appearing in myths around the world. Many stories involve his death and rebirth.
Messiah Picaro	A Persona turned picaro after becoming the Trickster's mask. He appears before Judgment Day to save the virtuous. He is a universal figure, appearing in myths around the world.
Orpheus Picaro	A Persona turned picaro after becoming the Trickster's mask. A Greek poet who tried to retrieve his wife from Hades, but she vanished when he looked back before reaching the surface.
Thanatos Picaro	A Persona turned picaro after becoming the Trickster's mask. The Greek god of death, he is the son of Nyx and the twin brother of Hypnos. He is known to provide mortals with a peaceful death.
Izanagi Picaro	A Persona turned picaro after becoming the Trickster's mask. One of the ancient gods who existed before Japan was formed. He created the Oyashima from chaos, then gave birth to countless children.
M. Izanagi Picaro	A Persona turned picaro after becoming the Trickster's mask. He is Izanagi's rival. Magatsu means "calamity," so, unlike Izanagi who founded the land and brought order, he leads all back into chaos.
Kaguya Picaro	A Persona turned picaro after becoming the Trickster's mask. She appeared from a glowing bamboo shoot. She received many proposals, but rejected them and returned to the moon.
Ariadne Picaro	A Persona turned picaro after becoming the Trickster's mask. She is the daughter of Minos. She helped Theseus defeat the Minotaur and gave him a ball of yarn so he could escape the labyrinth.
Asterius Picaro	A Persona turned picaro after becoming the Trickster's mask. Son of Pasiphae, he was born a bull- headed monster. Locked away in the labyrinth as the Minotaur, he wielded a double-sided axe.
Tsukiyomi Picaro	A Persona turned picaro after becoming the Trickster's mask. An important god born from the Japanese god Izanagi, he governs over the moon and the night. There are many theories behind this mysterious god.
Satanael	RESERVE Mythology
???	A being based off of the main character of Maurice Leblanc's novels, Arsene Lupin. He appears everywhere and is a master of disguise. He is known to help law-abiding citizens.
Arsene	A being based off of the main character of Maurice Leblanc's novels, Arsene Lupin. He appears everywhere and is a master of disguise. He is known to help law-abiding citizens.
Captain Kidd	A 17th century privateer who eventually became a world-renowned pirate. At his execution, he declared he had hidden treasure, leaving behind many legends.
Zorro	A masked swordsman of justice who fought in California against corrupt officials during the era of Spanish rule. He always left his "Z" mark with his rapier wherever he appeared.
Carmen	A gypsy thief from the novel by Merimee, which became famous through the opera by Bizet. She is a femme fatale who is beautiful but also very capricious.
Goemon	Ishikawa Goemon was a thief who stole from the rich and gave to the poor in Japan during the Azuchi-Momoyama period. The kabuki scene of him sitting on the gate of Nanzen-ji is famous.
Johanna	The mysterious female pope of the Middle Ages. She posed as a man and eventually made it all the way up to pope due to her unrivaled intellect. Her existence shook the history of the Catholic church.
Milady	The beautiful woman that appears in Dumas's "Three Musketeers." Branded with a fleur-de-lis symbol, she used many aliases to control nobility and get her vengeance.
Necronomicon	The grimoire which contains vital information of the Cthulhu mythos by Lovecraft. Its original name is Al Azif. It is said the book itself is alive.
Robin Hood	A noble thief that made waves in England during the Middle Ages. He is an expert archer and leader of the Merry Men, outlaws of justice who made Sherwood Forest their home.
Loki	RESERVE Mythology
Satanael	An archangel who is said to be the form of Satan before he fell from Heaven. The second son of God, he rebelled against Him for freedom and bestowed free will and chaos upon humanity.
Seiten Taisei	A title Sun Wukong had given himself. Born from a rock, he wreaked havoc and was punished by Buddha who imprisoned him under a mountain. Eventually, he was saved by a monk named Xuanzang.
Mercurius	The Roman god of travelers and thieves. A diverse god, he is seen as a symbol of the human unconscious and the mental world. He is equated with the Philosopher's Stone, the ultimate mystery in the field of alchemy.
Hecate	A Greek goddess of crossroads, ghosts, and witchcraft, she is commonly attended to by dogs. She is also known to be the chief of the witches that appear in the play "Macbeth."
Kamu Susano-o	A Japanese god found in the Izumo Fudoki. He was one of the three gods born from Izanagi. He was a violent ruffian, but also had a sensitive side, showing love for his mother and reading poems.
Anat	The daughter of Ugaritic's highest god El. She is the goddess of fertility, as well as hunting and war. Her characteristics are the characteristics of the seasons in Canaan.
Astarte	A Middle Eastern goddess of fertility. Many scriptures note her folklore, and there is even a mention of her as the "Queen of Heaven" in the Bible.
Prometheus	The Greek Titan who created mankind from clay. He later stole fire from Olympus and, in turn, gave it to mankind against Zeus's will. His name is often synonymous with fire and "divine knowledge."
Loki	RESERVE Mythology
Arsene	RESERVE Mythology
Captain Kidd	RESERVE Mythology
Zorro	RESERVE Mythology
Carmen	RESERVE Mythology
Goemon	RESERVE Mythology
Johanna	RESERVE Mythology
Milady	RESERVE Mythology
Necronomicon	RESERVE Mythology
Robin Hood	RESERVE Mythology
???	RESERVE Mythology
Lucifer	RESERVE231 Mythology
Seiten Taisei	RESERVE231 Mythology
Mercurius	RESERVE231 Mythology
Hecate	RESERVE231 Mythology
Kamu Susano-o	RESERVE231 Mythology
Anat	RESERVE231 Mythology
Astarte	RESERVE231 Mythology
Prometheus	RESERVE231 Mythology
Loki	RESERVE231 Mythology
Loki	A malignant god of Norse mythology. Not always driven by malice, but impulsive and devious. He had an uneasy peace with Odin and the gods, but his part in Baldr's death drove them to finally punish him.
Cendrillon	The French name of the titular heroine of Cinderella, an oft- retold tale of great renown in which a mistreated waif gains luxury, beauty, and a single night's dance with a prince through the power of magic.
Vanadis	The true name of Freyja, of the Norse Vanir deities. Younger twin sister of Freyr. Her name means "dis of the Vanir"-dis being a goddess. Known to be a great beauty and a witchlike master of magic.
William	The other name of Captain Kidd, world- renowned pirate. For years after his death, songs and legends of his life inspired many to chase rumors of his buried treasure across the seas.
Diego	The true name of California's masked swordsman of justice, who fought corrupt officials during the era of Spanish rule. Despite being marked as a thief, he fought for the weak as a true gentleman.
Celestine	A beautiful actress who performed as Carmen in the opera named for the role. So tempestuous and outspoken was she that it's said the main role was rewritten to better suit her.
Gorokichi	Childhood nickname of Goemon Ishikawa. During his youth, he was raised among the Iga-ryu ninjas before he set off on his own to become a rogue ninja.
Agnes	Another name of Johanna, the female pope of the Middle Ages. Posing as a man, her wits and ability helped her climb the ranks. Her story shook the Catholic church to its core.
Lucy	The Countess of Carlisle, and the historical basis for Alexandre Dumas's femme fatale, Milady de Winter. Known for her beauty and cunning, she was a courtier much favored by the Queen.
Al Azif	The original name of the Necronomicon, a tome full of the Cthulhu Mythos's mysteries. Said to have been authored by Abdul Alhazred, a poet and devotee of Cthulhu known as the "mad Arab."
Hereward	The legendary Saxon who opposed the Normans during the conquest of England in the 11th century. Said to have been the basis for tales of Robin Hood. Called "Hereward the Wake" for his watchfulness.
Ella	The true name of Cinderella's heroine. "Cinder Ella" was a derisive nickname, born from her hard work always leaving her dusty and sooty. After marrying her prince, she became "Princess Ella."
RESERVE	A fallen angel in Judeo-Christian lore whose name signifies "Morning Star." Primarily known for defying God but also worshipped as a bringer of light to mankind.
Satan	The Judeo-Christian prince of darkness, he is known for his role as the snake that tempted Adam and Eve in Eden. It is also said that he was sent by God to test man's piety.
Lucifer	A fallen Judeo- Christian angel, he led a rebellion with an army of angels against God and lost. He waits in Hell for his chance to challenge God once more and strike Him down.
Kohryu	Known as the Gold Dragon, it reigns over the Ssu-Ling, celestial creatures of Chinese lore. It is located at the center of the four beasts.
Okuninushi	A Kunitsu deity of Japanese mythology that governs agriculture and medicine. He is said to have built the country of Izumo with Susano-o's daughter, Suseri-Hime.
Norn	Goddesses of fate in Norse myth. They live below the roots of Yggdrasil and weave the threads of fate, by which even the gods are bound.
RESERVE	A Hindu god of war, known as Skanda or Murugan. He rides atop a peacock called Paravani, with bow and arrow drawn. He commands the army of the gods and defeated the forces of Asura.
RESERVE	Seven days after its birth, a wolf killed its mother. Yoshizane Satomi later promised his daughter's hand if it could defeat the enemy, but after Yatsufusa's success, Yoshizane's retainer shot it dead.
Futsunushi	The Nihonshoki sword deity who pacified Ashihara- no-Nakatsukuni. His name comes from "futsu," the fashion in which things are cut, and "nushi," his nature as a god.
RESERVE	RESERVE Mythology
Seth	The Egyptian god of the desert, chaos, and evil. He murdered his brother, Osiris, and tried to become chief god, but he was castrated by Osiris's son, Horus.
Ishtar	The revered goddess of war and love in ancient Mesopotamia. She seduced many men to their doom. When Gilgamesh, the hero, spurned her, she murdered his best friend, Enkidu.
RESERVE	RESERVE Mythology
Surt	A fire giant in Norse lore. He rules the fire realm, Muspelheim, and brandishes a burning sword. At Ragnarok, he will set the world ablaze.
???	The German name of the hero in the epic poem, "The Nibelungenlied." The dragon Fafnir's blood made him invincible, but a single leaf on his back resulted in a weak spot.
Lakshmi	The Hindu goddess of beauty and good fortune, Vishnu's wife, and Kama's mother. She is the goddess of love, believed to have been born from an ocean of milk.
RESERVE	A god who migrated from Silla to Kyushu to give oracles to the people. Later deified as a guardian of samurai across Japan. Also called Yahata, or "a figure for gods to possess."
RESERVE	RESERVE Mythology
Ex-Belphegor	Demonic governor of the deadly sin of sloth, who also excels at invention and discovery. May derive from Ba'al Pe'or, Syrian god of abundant crops.
RESERVE	A cursed Norse spirit in the form of a beautiful woman, known to bloom from the blood of hanged men. She was believed to tell secrets if properly tended to.
Garuda	A divine bird-man in Hindu lore. He once fought the gods and received immortality in exchange for becoming Vishnu's carrier.
Fortuna	The Roman goddess of luck, she spins the Wheel of Fortune. She is believed to have originally been a fertility goddess. Her Greek counterpart is Tyche.
Suzaku	One of the Ssu-Ling, celestial creatures of Chinese myth. It is a giant bird that is said to chirp in five beautiful voices. It represents the direction south, the season of summer, and the element of fire.
Seiryu	The noblest of the Ssu-Ling creatures of Chinese myth. It represents the direction east, the season of spring, and the element of wood. It dwells in a palace at the bottom of the ocean.
Genbu	One of the Ssu-Ling, celestial creatures of Chinese myth. It represents the direction north, the season of winter, and the element of water. Known to be a great warrior, it supports the Earth from below.
Byakko	One of the Ssu-Ling, celestial creatures of Chinese myth. It represents the direction west, the season of autumn, and the element of metal. He is believed to be the king of all beasts.
Bishamonten	Also known as Tamonten and Vaishravana in Buddhist lore, he is the strongest of the Heavenly Kings. He protects the North and is the god of war.
Koumokuten	Also known as Virupaksha, he is the protector of the West, and is one of the Four Heavenly Kings of Buddhist origin. He keeps a close watch on the world with his sharp gaze.
Jikokuten	Also known as Dhritarashtra, he is the protector of the East, and is one of the Four Heavenly Kings of Buddhist origin. He helps maintain the security of the nation.
Zouchouten	Also known as Virudhaka, he is the protector of the South, and is one of the Four Heavenly Kings of Buddhist origin. He is the god of the five grains, and was once the chief of the gods.
Hell Biker	A motorcyclist whose violent nature turned him into a demon. His anger with himself and the world causes him to lash out, that everyone else would suffer as well.
Daisoujou	A monk who died while fasting, his spiritual power allows his body to continue to exist without rotting. It is said that he will appear before people on the day of salvation.
Trumpeter	Angels that sound the trumpets at the time of the Apocalypse. As each trumpet sounds, the more plagues and disasters will occur, turning the earth into a land of death and suffering.
White Rider	One of the Four Horsemen of the Apocalypse, he rides a white horse with a bow in hand. A crown was granted to him, and he promises victory.
Matador	A master sportsman who entertains the audience in exchange for his own life: one mistake can mean death. Some believe that matadors who die while performing remain in this world.
Pale Rider	One of the Four Horsemen of the Apocalypse, he rides a pale horse and represents death. He has the power to destroy life.
Horus	An ancient god of Egypt whose eyes are the sun and moon. Revered by some as the chief god, he is often depicted as a hawk or a falcon.
RESERVE	RESERVE Mythology
Attis	A Phrygian god who symbolizes life, death, and revival. He rejected Cybele's love and was driven mad, dying after he castrated himself. Cybele then resurrected him.
RESERVE	RESERVE Mythology
RESERVE	The god of war in Greek myth. Other gods despised him for his cruel and violent nature. He opposed Athena, who resented war.
Sraosha	In Zoroastrian lore, Sraosha's duty is to listen to the cry of humans for Ahura Mazda. He is also known to descend after sunset to vanquish evil. His name literally means "observance."
Berith	One of the 72 demons of the Goetia. Known as the Duke of Hell, he rides a gigantic horse and burns those without manners.
RESERVE	Japanese god of words, thought to be the deification of echoes. Said to proclaim good and bad in a single word, and all words uttered by him come true.
Mitra	An ancient Persian god of contracts, who was also revered as a sun god who brought harvests when he was introduced to the Zoroastrian religion.
Phoenix	The legendary bird of Chinese myth, said to appear only in times of peace. It is the ruler of all birds. When it dies, birds across the land chirp with sadness.
Principality	The seventh of the nine orders of angels. They guard cities and nations, and protect various religious figures.
Neko Shogun	A prophetic Taoist god, originally known as Mao Shogun. Due to a linguistic error involving the Chinese word for "cat," his name was changed to Neko Shogun.
Vasuki	A giant serpent of Hindu legend. It is said the gods and demons used him to churn the sea of milk. The strain caused him to exhale incredibly potent venom, but Shiva swallowed it.
Ananta	The 1,000-headed serpent of Hindu legend, Ananta is Sanskrit for "infinite." After resting on him, Vishnu woke up and created the universe.
Throne	The third of the nine orders of angels. They are the angels of dignity and justice who carry God's throne and govern thought. They are angels of knowledge.
RESERVE	RESERVE Mythology
Quetzalcoatl	An Aztec deity known as the Feathered Serpent. He created humans with his own blood and taught them how to sustain themselves.
Red Rider	One of the Four Horsemen of the Apocalypse, he rides a red horse and carries a great sword. He has the power to destroy peace and make men slay one another.
Black Rider	One of the Four Horsemen of the Apocalypse, he rides a black horse and carries scales. He brings famine and has the right to end lives through suffering.
RESERVE	Shiva's first consort in Hindu myth, she threw herself into a sacrificial fire in protest of her father's treatment of Shiva. Reborn as Parvati, she was reunited with Shiva.
Ex-Moloch	A Canaanite god of fire. A bronze statue of a man with a bull's head stands at an altar. Sacrificial children were thrown into the statue after it was heated.
Pazuzu	The Babylonian lord of wind and scorching sands. He has the body of a man, a lion's head, the claws and wings of an eagle, and has a deadly poison. The diseases he spreads can only be cured with magic.
???	RESERVE Mythology
Slime	RESERVE Mythology
Jack-o'-Lantern	RESERVE Mythology
Agathion	RESERVE Mythology
Mandrake	RESERVE Mythology
Shiisaa	RESERVE Mythology
Jack Frost	RESERVE Mythology
Sudama	RESERVE Mythology
Onmoraki	RESERVE Mythology
Bugs	RESERVE Mythology
Pixie	RESERVE Mythology
Pixie	RESERVE Mythology
Ardha	RESERVE Mythology
RESERVE	RESERVE Mythology
Asmodeus	RESERVE Mythology
Azazel	RESERVE Mythology
Baal	RESERVE Mythology
Tithoes	RESERVE Mythology
Mammon	RESERVE Mythology
Leviathan	RESERVE Mythology
Samael	RESERVE Mythology
Maria	The maternal figure of Christianity. Gabriel informed her that she was to be the mother of Jesus. Some sects revere her as the Virgin Mary, but other denominations do not focus on her.
Vohu Manah	The second of Zoroastrianism's "divine sparks," Amesha Spenta, its name means "good thought." This holy entity is said to have given Zoroaster revelations from God.
Cait Sith	A fae beast from the Scottish highlands. Their kingdoms are in tree hollows or abandoned houses. Dog-sized, with vivid green eyes. Some live with humans, as they understand our speech.
Mishaguji	An indigenous god of the Shinano region from before the forces of Yamato occupied the land. Said to be born from the belief that divine spirits dwelled in rocks and stones.
???	RESERVE Mythology
???	RESERVE Mythology
RESERVE	RESERVE Mythology
RESERVE	RESERVE Mythology
RESERVE	RESERVE Mythology
RESERVE	RESERVE Mythology
RESERVE	RESERVE Mythology
RESERVE	RESERVE Mythology
RESERVE	RESERVE Mythology
RESERVE	RESERVE Mythology
RESERVE	RESERVE Mythology
RESERVE	RESERVE Mythology
RESERVE	RESERVE Mythology
RESERVE	RESERVE Mythology
RESERVE	RESERVE Mythology
RESERVE	RESERVE Mythology
RESERVE	RESERVE Mythology
P5 Unused	RESERVE Mythology
P5 Unused	RESERVE Mythology
P5 Unused	RESERVE Mythology
P6 Unused	RESERVE Mythology
P5 Unused	RESERVE Mythology
P5 Unused	RESERVE Mythology
P5 Unused	RESERVE Mythology
P5 Unused	RESERVE Mythology
P5 Unused	RESERVE Mythology
Izanagi-no-Okami	A Persona of another story. A Japanese god of creation, he begat the sky, ocean, and night, and 8 million other gods. Opposes his once-wife, the goddess Izanami, after an encounter in Yomotsu Hirasaka.
Psyche	RESERVE Mythology
Athena	A Persona of another story. Daughter of Zeus, and a goddess of great martial ability. She fights to protect her land or her family, but never for sheer bloodlust. Her symbol is the olive tree.
Raoul	Another alias of Maurice Leblanc's hero, Arsene Lupin. Infamous as a phantom thief, he was also known to be a man of many friends, lovers, and treasured allies.
Orpheus Telos	RESERVE Mythology
Orpheus	A Persona of another story. A poet skilled with the lyre. He tried to retrieve his wife from Hades, but she vanished when he looked back before reaching the surface.
Izanagi-no-Okami Pic.	A Persona turned picaro after becoming the Trickster's mask. A Japanese god of creation, he begat the sky, ocean, and night, and 8 million other gods. Opposes his once-wife, the goddess Izanami.
Psyche Picaro	RESERVE Mythology
Athena Picaro	A Persona turned picaro after becoming the Trickster's mask. Daughter of Zeus, and a goddess of great martial ability. She fights for her land or her family, but never out of sheer bloodlust.
Neo Arsene Picaro	RESERVE Mythology
Orpheus Telos Picaro	RESERVE Mythology
Orpheus Picaro	A Persona turned picaro after becoming the Trickster's mask. A Greek poet who tried to retrieve his wife from Hades, but she vanished when he looked back before reaching the surface.
P5 Unused	RESERVE Mythology
P5 Unused	RESERVE Mythology
P5 Unused	RESERVE Mythology
P5 Unused	RESERVE Mythology
P5 Unused	RESERVE Mythology
P5 Unused	RESERVE Mythology
P5 Unused	RESERVE Mythology
P5 Unused	RESERVE Mythology
P5 Unused	RESERVE Mythology
P5 Unused	RESERVE Mythology
P5 Unused	RESERVE Mythology
P5 Unused	RESERVE Mythology
P5 Unused	RESERVE Mythology
P5 Unused	RESERVE Mythology
P5 Unused	RESERVE Mythology
P5 Unused	RESERVE Mythology
P5 Unused	RESERVE Mythology
P5 Unused	RESERVE Mythology
P5 Unused	RESERVE Mythology
P5 Unused	RESERVE Mythology
P5 Unused	RESERVE Mythology
P5 Unused	RESERVE Mythology
P5 Unused	RESERVE Mythology
P5 Unused	RESERVE Mythology
P5 Unused	RESERVE Mythology
P5 Unused	RESERVE Mythology
P5 Unused	RESERVE Mythology
P5 Unused	RESERVE Mythology
P5 Unused	RESERVE Mythology
P5 Unused	RESERVE Mythology
P5 Unused	RESERVE Mythology
P5 Unused	RESERVE Mythology
P5 Unused	RESERVE Mythology
P5 Unused	RESERVE Mythology
P5 Unused	RESERVE Mythology
P5 Unused	RESERVE Mythology
P5 Unused	RESERVE Mythology
P5 Unused	RESERVE Mythology
P5 Unused	RESERVE Mythology
P5 Unused	RESERVE Mythology
P5 Unused	RESERVE Mythology
P5 Unused	RESERVE Mythology
P5 Unused	RESERVE Mythology
P5 Unused	RESERVE Mythology
P5 Unused	RESERVE Mythology
P5 Unused	RESERVE Mythology
P5 Unused	RESERVE Mythology
P5 Unused	RESERVE Mythology
P5 Unused	RESERVE Mythology
P5 Unused	RESERVE Mythology
P5 Unused	RESERVE Mythology
P5 Unused	RESERVE Mythology
Macabre	An evil spirit with the same name as the Death appearing in medieval oratorios. It is depicted as a skeleton with a black cloak and a sickle to reap humans. It dances the feared "Dance of Death."
Alilat	The Arabian mother goddess also known as Allat. She was thought to reside in the Black Stone at the Kaaba. She and her son, Dusura, were worshipped there by desert nomads.
Thunderbird	A revered bird of Native American mythology said to live atop cloud-shrouded peaks. Resembles an eagle. Its wingbeats create thunderclaps, and some legends say its eyes can unleash lightning.
Fafnir	An evil dragon of Norse lore, it was vanquished by the hero, Siegfried. According to the Volsunga saga, it was venomous, had legs like snakes, and shook the ground with every step.
Byakhee	A malformed, winged servant of the Cthulhu Mythos's cosmic god Hastur. They can fly even in the vacuum of space, and it's said that if you can summon one, it will carry you wherever you wish.
Hastur	An evil god of the Cthulhu Mythos and one of the eldritch deities known as Great Old Ones. It wields great power over wind. Also called "The Unspeakable" and "The King in Yellow."
Tam Lin	A fae knight of the Seelie Court, said to protect the forest of Carterhaugh. After being kidnapped by the faeries at the tender age of 9, he lived much of his life among them.
Throne	The third of the nine orders of angels. They are the angels of dignity and justice who carry God's throne and govern thought. They are angels of knowledge.
Surt	A fire giant in Norse lore. He rules the fire realm, Muspelheim, and brandishes a burning sword. At Ragnarok, he will set the world ablaze.
Loa	A general name for gods and spirits of Vodum. The gods that actually affect human lives are called by this name. Those with negative power are said to be able to kill with a fatal curse.
Chimera	Part lion, part goat and part snake, this creature originally represented the seasons. In Greek mythology, it was viewed as a violent monster. Born of Typhon and Echidna.
Atavaka	One of the eight Yashaou. His domain is war and protection. Once a child-eating demon, he became one of the greatest of the Wisdom Kings after Buddha converted him to good.
Cait Sith	A fae beast from the Scottish highlands. Their kingdoms are in tree hollows or abandoned houses. Dog-sized, with vivid green eyes. Some live with humans, as they understand our speech.
Siegfried	The German name of the hero in the epic poem, "The Nibelungenlied." The dragon Fafnir's blood made him invincible, but a single leaf on his back resulted in a weak spot.
P5 Unused	RESERVE Mythology
P5 Unused	RESERVE Mythology
???	RESERVE Mythology
???	RESERVE Mythology
???	RESERVE Mythology
???	RESERVE Mythology
???	RESERVE Mythology
???	RESERVE Mythology
???	RESERVE Mythology
???	RESERVE Mythology
???	RESERVE Mythology
???	RESERVE Mythology
???	RESERVE Mythology
???	RESERVE Mythology
???	RESERVE Mythology
???	RESERVE Mythology
???	RESERVE Mythology
???	RESERVE Mythology
???	RESERVE Mythology
???	RESERVE Mythology
???	RESERVE Mythology
???	RESERVE Mythology
???	RESERVE Mythology
???	RESERVE Mythology
RESERVE	RESERVE Mythology
RESERVE	RESERVE Mythology 
